asia = {
	2 3 5 6 7 8 9 10 11 12 13 14 15 16 17 18 19 20 21 22 23 24 25 26 27 28 29 30 31 32 33 34 35 36 37 38 39 40 41 42 43 44 45 46 47 48 49 50 
	51 52 53 54 55 56 57 58 59 60 61 62 63 64 65 66 67 68 69 70 71 72 73 74 75 76 77 78 79 80 81 82 83 84 85 86 87 88 89 90 91 92 93 94 95 96 97 98 99 100
	101 102 103 104 105 106 107 108 109 110 111 112 113 114 115 116 117 118 119 120 121 122 123 124 125 126 127 128 129 130 131 132 133 134 135 136 137 138 139 140 141 142 143 144 145 146 147 148 149 150 
	151 152 153 154 155 156 157 158 159 160 161 162 163 164 165 166 167 168 169 170 171 172 173 174 175 176 177 178 179 180 181 182 183 190 191 192 193 194 195 196 197 198 661 662
	663 664 665 666 667 668 669 670 671 672 673 674 675 676 677 678 679 680 681 682 683 684 685 686 687 688 689 690 692 694 699 700 705 710 711 737 738 740 1012 1014 1015 1016 1017 1018 1019 1020 1021 1022
	1023 1028 1029 1030 1051 1100 1101 1248 1779 1784 1785 1786 1787 1788 1815 1816 1817 1818 1819 1820 1821 1822 1823 1824 1825 1826 1827 1828 1829 1830 1832 1833
	1835 1836 1837 1838 1839 1840 1841 1842 1843 1844 1845 1846 1847 1848 1849 1850 1852 1854 1895 1896 1897 1898 1946 1947 1948 1949 1950 1994
	2000 2001 2027 2028 2029 2030 2031 2032 2033 2034 2035 2036 2037 2038 2039 2040 2041 2042 2043 2044 2045 2046 2047 2048 2049 2050 2051 2052 2053 2054 2055 2056 2057 2058 2059 2060 2061 2062 2063
	2064 2065 2066 2067 2068 2069 2070 2071 2072 2073 2074 2075 2076 20777 2078 2079 2080 2081 2082 2083 2084 2085 2086 2087 2088 2089 2090 2091 2092 2093 2094 2095 2096 2096 2097 2098 2099 2100 2101 2124 2125 2128 
	2129 2130 2131 2132 2133 2134 2135 2137 2140 2141 2142 2143 2144 2146 2147 2148 2149 2150 2151 2152 2153 2154 2155 2156 2157 2158 2159 2160 2161 2162 2163 2164 2165 2166 2167 2168 2169 2170 2171 2172 2173 2174
	2175 2176 2177 2178 2179 2180 2181 2182 2183 2184 2200 2219 2220 2221 2222 2223 2224 2225 2226 2227 2228 2229 2230 2231 2232 2233 2234 2235 2333 2339 2341 2342 2343 2347 2371 2372 2373 2374 2375 2376 2377 2378 2379
	2380 2381 2382 2383 2384 2385 2386 2387 2388 2389 2390 2391 2392 2393 2394 2395 2396 2397 2398 2399 2400 2401 2402 2403 2404 2673 2674 2675 2676 2677 2678 2679 2680 2681 2682 2683 2684 2685 2686 2687 2688 2689 2690 
	2691 2692 2693 2694 2695 697 2698 2699 2700 2701 2702 2703 2704 2705 2706 2707 2708 2709 2710 2711 2712 2713 2714 2715 2716 2740 2741 2745 2748 2999 4180 
	4181 4182 4183 4184 4185 4186 4187 4188 4189 4190 4196 4197 4198 4199 4205 4211 4212 4213 4224 4227 4228 4283 4284 4286 4287 4324 4325 4326 4327 4328 4329 4330 4332 4334 4336 4337 4345 4348 4349 4350 4351 4352 4353
	4354 4355 4356 4359 4360 4393 4394 4395 4396 4397 4398 4399 4400 4401 4402 4403 4404 4405 4406 4407 4408 4409 4410 4411 4412 4413 4414 4415 4416 4417 4418 4419 4420 4421 4422 4423 4424 4425 4426 4427 4428 4429 4430
	4431 4432 4433 4434 4435 4436 4437 4438 4439 4440 4441 4442 4443 4444 4445 4446 4447 4448 4449 4450 4451 4452 4453 4454 4455 4456 4457 4458 4459 4460 4461 4462 4463 4464 4465 4466 4467 4468 4469 4470 4471 4472 4473
	4474 4475 4476 4477 4478 4479 4480 4481 4482 4483 4484 4485 4486 4487 4488 4489 4490 4491 4492 4493 4494 4495 4496 4497 4498 4499 4500 4501 4502 4503 4504 4505 4506 4507 4508 4509 4510 4511 4512 4513 4514 4515 4516
	4517 4518 4519 4520 4521 4651 4652 4653 4654
}
africa = {
	1099 1206 2024 2786 2788
}
oceania = {
	184 185 186 187 188 189 1235 1236 1237 1238 1245 1789 1990 1992 1993 1995 1996 2696 2717 2718 2719 2720 2721 2722 2723 2724 2725
}
# Used for RNW
new_world = {
}